1385058568	1385058816	3232392	711 BED Dorothy Schonhans	N Firbank Central Bed	248
1385058002	1385058554	3232370	444	Westmorland Dukane Bed	552
1385057743	1385058380	3232359	EXIT DOOR NEW WALKWAY TO PARKING	CROSSLANDS Door Alert Device	637
1385057725	1385058482	3232355	XL LOT 12 PICK UP NEEDED	XL PARKING LOTS	757
1385057630	1385058052	3232343	EXIT DOOR FIRBANK CENTRAL NEAR RM 715	CROSSLANDS Door Alert Device	422
1385057501	1385057703	3232340	406	Westmorland Dukane Bath	202
1385057376	1385057848	3232329	304B Elva King	Firbank West  Bed	472
1385057253	1385057481	3232322	 707 BED Jeanne Harkins	N Firbank Central Bed	228
1385057125	1385058180	3232313	312 Harriett Fitts	Firbank Central Bath	1055
1385056963	1385058765	3232310	336	Firbank East Chair	1802
1385056868	1385058670	3232304	331	Firbank East Bed	1802
1385056841	1385058643	3232303	334	Firbank East Bed	1802
1385056753	1385058556	3232299	355	Firbank East Bath	1803
1385056659	1385058461	3232297	356	Firbank East Bed	1802
1385056638	1385058441	3232296	XL Firbank East RM  331	Repeaters and Locators	1803
1385056629	1385056933	3232295	Lydia Hall - Pendant	Audland Pendants	304
1385056602	1385058404	3232293	Firbank East Door Pk Lot hol dstill there unused 11/12/12 steve	STEVES HOLD UN-USED DEVICE AREA	1802
1385056559	1385058361	3232292	335	Firbank East Chair	1802
1385056495	1385058298	3232282	353	Firbank East Chair	1803
1385056457	1385058260	3232280	Mott House Steve Office	Steve's Check In WATCH Area	1803
1385056408	1385058209	3232277	355	Firbank East Chair	1801
1385056378	1385056570	3232275	EXIT DOOR NEW WALKWAY TO PARKING	CROSSLANDS Door Alert Device	192
1385056327	1385058130	3232272	337	Firbank East Bed	1803
1385056319	1385058121	3232271	351	Firbank East Bath	1802
1385056277	1385058078	3232269	339	Firbank East Chair	1801
1385056260	1385058062	3232268	KEN GEN Switch OFF Boiler room Kendal OLD	STEVES HOLD UN-USED DEVICE AREA	1802
1385056176	1385057979	3232264	548 BED	STEVES HOLD UN-USED DEVICE AREA	1803
1385056062	1385057864	3232260	336	Firbank East Bed	1802
1385056008	1385057810	3232257	343	Firbank East Chair	1802
1385055976	1385057777	3232254	BLAH	Steve's Check In WATCH Area	1801
1385055923	1385057726	3232252	338	Firbank East Bed	1803
1385055909	1385057711	3232251	355	Firbank East Bed	1802
1385055900	1385057702	3232250	349	Firbank East Chair	1802
1385055891	1385057694	3232249	345	Firbank East Chair	1803
1385055882	1385057683	3232248	340	Firbank East Bed	1801
1385055878	1385057680	3232247	333	Firbank East Chair	1802
1385055876	1385057677	3232246	350	Firbank East Bed	1801
1385055872	1385057674	3232245	334	Firbank East Chair	1802
1385055872	1385057674	3232244	333	Firbank East Bed	1802
1385055869	1385057671	3232243	338	Firbank East Chair	1802
1385055802	1385056007	3232241	307 Gus Schroeder	Firbank Central Bath	205
1385055769	1385056000	3232240	Kendal Apt 64	Steve's Check In WATCH Area	231
1385055665	1385057468	3232234	335	Firbank East Bed	1803
1385055645	1385057447	3232233	352	Firbank East Bed	1802
1385055645	1385057447	3232232	353	Firbank East Bed	1802
1385055645	1385057446	3232231	356	Firbank East Chair	1801
1385055645	1385057446	3232230	348	Firbank East Chair	1801
1385055620	1385057422	3232229	344	Firbank East Chair	1802
1385055572	1385057373	3232228	HR Office Door	Office Activity	1801
1385055533	1385055979	3232227	EXIT DOOR FIRBANK CENTRAL NEAR RM 715	CROSSLANDS Door Alert Device	446
1385055484	1385057286	3232225	337	Firbank East Chair	1802
1385055443	1385057246	3232224	333	Firbank East Bath	1803
1385055437	1385057240	3232223	341	Firbank East Bed	1803
1385055354	1385057156	3232220	341	Firbank East Chair	1802
1385055339	1385056413	3232219	312 Harriett Fitts	Firbank Central Chair	1074
1385055336	1385057138	3232218	340	Firbank East Chair	1802
1385055324	1385057126	3232217	349	Firbank East Bed	1802
1385055311	1385055526	3232216	307 Gus Schroeder	Firbank Central Bath	215
1385055252	1385056505	3232213	312 Bed Harriet Fitts	Firbank West  Bed	1253
1385055160	1385056963	3232212	336	Firbank East Chair	1803
1385055065	1385056868	3232211	331	Firbank East Bed	1803
1385055040	1385056841	3232208	334	Firbank East Bed	1801
1385054951	1385056753	3232206	355	Firbank East Bath	1802
1385054857	1385056659	3232201	356	Firbank East Bed	1802
1385054836	1385056638	3232199	XL Firbank East RM  331	Repeaters and Locators	1802
1385054800	1385056602	3232197	Firbank East Door Pk Lot hol dstill there unused 11/12/12 steve	STEVES HOLD UN-USED DEVICE AREA	1802
1385054757	1385056559	3232194	335	Firbank East Chair	1802
1385054694	1385056495	3232192	353	Firbank East Chair	1801
1385054604	1385056407	3232189	355	Firbank East Chair	1803
1385054525	1385056327	3232186	337	Firbank East Bed	1802
1385054516	1385056319	3232185	351	Firbank East Bath	1803
1385054474	1385056276	3232184	339	Firbank East Chair	1802
1385054457	1385056260	3232182	KEN GEN Switch OFF Boiler room Kendal OLD	STEVES HOLD UN-USED DEVICE AREA	1803
1385054375	1385056176	3232179	548 BED	STEVES HOLD UN-USED DEVICE AREA	1801
1385054259	1385056062	3232177	336	Firbank East Bed	1803
1385054207	1385056008	3232176	343	Firbank East Chair	1801
1385054174	1385055976	3232175	BLAH	Steve's Check In WATCH Area	1802
1385054121	1385055923	3232174	338	Firbank East Bed	1802
1385054108	1385055909	3232173	355	Firbank East Bed	1801
1385054099	1385055900	3232172	349	Firbank East Chair	1801
1385054090	1385055891	3232171	345	Firbank East Chair	1801
1385054081	1385055882	3232170	340	Firbank East Bed	1801
1385054075	1385055876	3232169	350	Firbank East Bed	1801
1385054075	1385055878	3232168	333	Firbank East Chair	1803
1385054070	1385055872	3232167	334	Firbank East Chair	1802
1385054070	1385055872	3232166	333	Firbank East Bed	1802
1385054066	1385055869	3232165	338	Firbank East Chair	1803
1385053863	1385055665	3232160	335	Firbank East Bed	1802
1385053842	1385055644	3232159	352	Firbank East Bed	1802
1385053842	1385055644	3232158	353	Firbank East Bed	1802
1385053842	1385055644	3232157	356	Firbank East Chair	1802
1385053842	1385055644	3232156	348	Firbank East Chair	1802
1385053817	1385055620	3232153	344	Firbank East Chair	1803
1385053771	1385055572	3232151	HR Office Door	Office Activity	1801
1385053732	1385055533	3232150	EXIT DOOR FIRBANK CENTRAL NEAR RM 715	CROSSLANDS Door Alert Device	1801
1385053683	1385055484	3232145	337	Firbank East Chair	1801
1385053640	1385055443	3232141	333	Firbank East Bath	1803
1385053634	1385055437	3232139	341	Firbank East Bed	1803
1385053624	1385053884	3232136	436	Westmorland Dukane Bed	260
1385053553	1385055354	3232134	341	Firbank East Chair	1801
1385053535	1385055336	3232133	340	Firbank East Chair	1801
1385053522	1385055324	3232132	349	Firbank East Bed	1802
1385053439	1385053725	3232130	Lydia Hall - Pendant	Audland Pendants	286
1385053357	1385055160	3232129	336	Firbank East Chair	1803
1385053264	1385055065	3232128	331	Firbank East Bed	1801
1385053239	1385055040	3232125	334	Firbank East Bed	1801
1385053150	1385054951	3232121	355	Firbank East Bath	1801
1385053124	1385053462	3232119	410	Westmorland Dukane Bath	338
1385053056	1385054857	3232117	356	Firbank East Bed	1801
1385053032	1385054836	3232116	XL Firbank East RM  331	Repeaters and Locators	1804
1385052998	1385054799	3232115	Firbank East Door Pk Lot hol dstill there unused 11/12/12 steve	STEVES HOLD UN-USED DEVICE AREA	1801
1385052984	1385054011	3232113	FB 613 CHAIR Betty Limberger	N Firbank West Bed	1027
1385052954	1385054757	3232111	335	Firbank East Chair	1803
1385052905	1385053170	3232109	Xlands Apt 241	Room Check Devices	265
1385052893	1385054694	3232107	353	Firbank East Chair	1801
1385052802	1385054604	3232105	355	Firbank East Chair	1802
1385052740	1385053846	3232104	Mott House Steve Office	Steve's Check In WATCH Area	1106
1385052722	1385054525	3232103	337	Firbank East Bed	1803
1385052713	1385054516	3232102	351	Firbank East Bath	1803
1385052673	1385054474	3232101	339	Firbank East Chair	1801
1385052655	1385054456	3232100	KEN GEN Switch OFF Boiler room Kendal OLD	STEVES HOLD UN-USED DEVICE AREA	1801
1385052629	1385053258	3232099	 707 BED Jeanne Harkins	N Firbank Central Bed	629
1385052572	1385054375	3232098	548 BED	STEVES HOLD UN-USED DEVICE AREA	1803
1385052456	1385054259	3232094	336	Firbank East Bed	1803
1385052405	1385054207	3232092	343	Firbank East Chair	1802
1385052371	1385054174	3232090	BLAH	Steve's Check In WATCH Area	1803
1385052320	1385054121	3232087	338	Firbank East Bed	1801
1385052307	1385054108	3232086	355	Firbank East Bed	1801
1385052296	1385054099	3232084	349	Firbank East Chair	1803
1385052289	1385054090	3232083	345	Firbank East Chair	1801
1385052279	1385054081	3232082	340	Firbank East Bed	1802
1385052273	1385054075	3232081	350	Firbank East Bed	1802
1385052273	1385054075	3232080	333	Firbank East Chair	1802
1385052267	1385054070	3232079	334	Firbank East Chair	1803
1385052267	1385054070	3232078	333	Firbank East Bed	1803
1385052264	1385054066	3232077	338	Firbank East Chair	1802
1385052062	1385053863	3232074	335	Firbank East Bed	1801
1385052039	1385053842	3232073	352	Firbank East Bed	1803
1385052039	1385053842	3232072	353	Firbank East Bed	1803
1385052039	1385053842	3232071	356	Firbank East Chair	1803
1385052039	1385053842	3232070	348	Firbank East Chair	1803
1385052014	1385053817	3232069	344	Firbank East Chair	1803
1385051968	1385053771	3232065	HR Office Door	Office Activity	1803
1385051838	1385053640	3232063	333	Firbank East Bath	1802
1385051838	1385053640	3232062	337	Firbank East Chair	1802
1385051831	1385053634	3232061	341	Firbank East Bed	1803
1385051751	1385053553	3232056	341	Firbank East Chair	1802
1385051733	1385053535	3232055	340	Firbank East Chair	1802
1385051721	1385053522	3232053	349	Firbank East Bed	1801
1385051663	1385051996	3232052	EXIT DOOR NEW WALKWAY TO PARKING	CROSSLANDS Door Alert Device	333
1385051625	1385052121	3232050	 XL lot 14 PICK UP NEEDED	XL PARKING LOTS	496
1385051555	1385053357	3232045	336	Firbank East Chair	1802
1385051462	1385053264	3232041	331	Firbank East Bed	1802
1385051437	1385053239	3232038	334	Firbank East Bed	1802
1385051402	1385051730	3232037	 717  BED Don Scarborough	N Firbank Central Bed	328
1385051347	1385053150	3232035	355	Firbank East Bath	1803
1385051277	1385051508	3232033	 607  CHAIR Marjorie Huber	N Firbank West Chair	231
1385051255	1385053056	3232032	356	Firbank East Bed	1801
1385051230	1385053032	3232031	XL Firbank East RM  331	Repeaters and Locators	1802
1385051196	1385052998	3232028	Firbank East Door Pk Lot hol dstill there unused 11/12/12 steve	STEVES HOLD UN-USED DEVICE AREA	1802
1385051151	1385052954	3232024	335	Firbank East Chair	1803
1385051091	1385052893	3232021	353	Firbank East Chair	1802
1385051001	1385052802	3232016	355	Firbank East Chair	1801
1385050939	1385052740	3232011	Mott House Steve Office	Steve's Check In WATCH Area	1801
1385050919	1385052722	3232010	337	Firbank East Bed	1803
1385050910	1385052713	3232009	351	Firbank East Bath	1803
1385050871	1385052673	3232008	339	Firbank East Chair	1802
1385050853	1385052655	3232007	KEN GEN Switch OFF Boiler room Kendal OLD	STEVES HOLD UN-USED DEVICE AREA	1802
1385050840	1385051041	3232006	EXIT DOOR FIRBANK WEST NEAR RM 615	CROSSLANDS Door Alert Device	201
1385050839	1385051322	3232005	322 Elizabeth Taylor	Firbank West  Chair	483
1385050769	1385052571	3231998	548 BED	STEVES HOLD UN-USED DEVICE AREA	1802
1385050654	1385052456	3231982	336	Firbank East Bed	1802
1385050602	1385052404	3231972	343	Firbank East Chair	1802
1385050569	1385052371	3231968	BLAH	Steve's Check In WATCH Area	1802
1385050517	1385052320	3231964	338	Firbank East Bed	1803
1385050504	1385052307	3231961	355	Firbank East Bed	1803
1385050492	1385052296	3231958	349	Firbank East Chair	1804
1385050487	1385052289	3231957	345	Firbank East Chair	1802
1385050477	1385052279	3231954	340	Firbank East Bed	1802
1385050472	1385052273	3231953	350	Firbank East Bed	1801
1385050472	1385052273	3231952	333	Firbank East Chair	1801
1385050465	1385052267	3231950	334	Firbank East Chair	1802
1385050465	1385052267	3231949	333	Firbank East Bed	1802
1385050461	1385052264	3231948	338	Firbank East Chair	1803
1385050450	1385051019	3231947	Xlands Apt 241	Room Check Devices	569
1385050307	1385051042	3231940	 607  BED Marjorie Huber	N Firbank West Bed	735
1385050260	1385052062	3231936	335	Firbank East Bed	1802
1385050236	1385052039	3231932	352	Firbank East Bed	1803
1385050236	1385052039	3231931	353	Firbank East Bed	1803
1385050236	1385052039	3231930	356	Firbank East Chair	1803
1385050236	1385052039	3231929	348	Firbank East Chair	1803
1385050212	1385052014	3231927	344	Firbank East Chair	1802
1385050167	1385051968	3231924	HR Office Door	Office Activity	1801
1385050036	1385051838	3231918	333	Firbank East Bath	1802
1385050036	1385051838	3231917	337	Firbank East Chair	1802
1385050025	1385050342	3231916	307 Gus Schroeder	Firbank Central Bath	317
1385049986	1385051787	3231915	341	Firbank East Bed	1801
1385049950	1385051751	3231912	341	Firbank East Chair	1801
1385049932	1385051733	3231910	340	Firbank East Chair	1801
1385049919	1385051721	3231909	349	Firbank East Bed	1802
1385049753	1385051555	3231906	336	Firbank East Chair	1802
1385049659	1385051462	3231905	331	Firbank East Bed	1803
1385049634	1385051437	3231899	334	Firbank East Bed	1803
1385049543	1385051347	3231896	355	Firbank East Bath	1804
1385049538	1385050735	3231895	EXIT DOOR NEW WALKWAY TO PARKING	CROSSLANDS Door Alert Device	1197
1385049453	1385051255	3231892	356	Firbank East Bed	1802
1385049428	1385051230	3231889	XL Firbank East RM  331	Repeaters and Locators	1802
1385049395	1385051196	3231887	Firbank East Door Pk Lot hol dstill there unused 11/12/12 steve	STEVES HOLD UN-USED DEVICE AREA	1801
1385049350	1385051151	3231883	335	Firbank East Chair	1801
1385049290	1385051091	3231882	353	Firbank East Chair	1801
1385049198	1385051001	3231877	355	Firbank East Chair	1803
1385049137	1385050939	3231871	Mott House Steve Office	Steve's Check In WATCH Area	1802
1385049118	1385050919	3231870	337	Firbank East Bed	1801
1385049109	1385050910	3231869	351	Firbank East Bath	1801
1385049069	1385050871	3231866	339	Firbank East Chair	1802
1385049052	1385050853	3231865	KEN GEN Switch OFF Boiler room Kendal OLD	STEVES HOLD UN-USED DEVICE AREA	1801
1385049029	1385049400	3231864	706   CHAIR Eleanor Taylor	N Firbank Central Chair	371
1385048966	1385050769	3231863	548 BED	STEVES HOLD UN-USED DEVICE AREA	1803
1385048850	1385050654	3231858	336	Firbank East Bed	1804
1385048801	1385050602	3231856	343	Firbank East Chair	1801
1385048768	1385050569	3231855	BLAH	Steve's Check In WATCH Area	1801
1385048716	1385050517	3231852	338	Firbank East Bed	1801
1385048702	1385050504	3231848	355	Firbank East Bed	1802
1385048690	1385050492	3231846	349	Firbank East Chair	1802
1385048685	1385050487	3231844	345	Firbank East Chair	1802
1385048674	1385050477	3231839	340	Firbank East Bed	1803
1385048670	1385050472	3231837	350	Firbank East Bed	1802
1385048668	1385050471	3231835	333	Firbank East Chair	1803
1385048663	1385050465	3231830	334	Firbank East Chair	1802
1385048663	1385050465	3231828	333	Firbank East Bed	1802
1385048659	1385050461	3231823	338	Firbank East Chair	1802
1385048476	1385049351	3231815	317 Carol Crotty	Firbank Central Bed	875
1385048459	1385050260	3231813	335	Firbank East Bed	1801
1385048445	1385048706	3231811	Marjorie Zacharias - Pendant	Audland Pendants	261
1385048434	1385050236	3231809	352	Firbank East Bed	1802
1385048434	1385050236	3231808	353	Firbank East Bed	1802
1385048434	1385050236	3231807	356	Firbank East Chair	1802
1385048434	1385050236	3231806	348	Firbank East Chair	1802
1385048425	1385048680	3231805	345	Firbank East Chair	255
1385048409	1385050212	3231802	344	Firbank East Chair	1803
1385048398	1385049033	3231801	406	Westmorland Dukane Bath	635
1385048376	1385048658	3231800	334	Firbank East Chair	282
1385048365	1385050167	3231794	HR Office Door	Office Activity	1802
1385048325	1385048690	3231792	349	Firbank East Chair	365
1385048257	1385048661	3231790	338	Firbank East Bed	404
1385048232	1385050036	3231784	333	Firbank East Bath	1804
1385048232	1385050036	3231783	337	Firbank East Chair	1804
1385048205	1385048658	3231781	333	Firbank East Bed	453
1385048183	1385049986	3231779	341	Firbank East Bed	1803
1385048147	1385049950	3231774	341	Firbank East Chair	1803
1385048135	1385048371	3231773	334	Firbank East Chair	236
1385048134	1385048373	3231771	340	Firbank East Bed	239
1385048132	1385048658	3231769	338	Firbank East Chair	526
1385048130	1385049932	3231767	340	Firbank East Chair	1802
1385048118	1385049919	3231765	349	Firbank East Bed	1801
1385048096	1385048670	3231761	350	Firbank East Bed	574
1385048028	1385048663	3231757	333	Firbank East Chair	635
1385047951	1385049753	3231753	336	Firbank East Chair	1802
1385047858	1385049659	3231750	331	Firbank East Bed	1801
1385047831	1385049634	3231748	334	Firbank East Bed	1803
1385047742	1385049543	3231743	355	Firbank East Bath	1801
1385047651	1385049453	3231738	356	Firbank East Bed	1802
1385047626	1385049428	3231736	XL Firbank East RM  331	Repeaters and Locators	1802
1385047592	1385049395	3231733	Firbank East Door Pk Lot hol dstill there unused 11/12/12 steve	STEVES HOLD UN-USED DEVICE AREA	1803
1385047546	1385049349	3231732	335	Firbank East Chair	1803
1385047488	1385049290	3231726	353	Firbank East Chair	1802
1385047396	1385049198	3231717	355	Firbank East Chair	1802
1385047381	1385048095	3231715	340	Firbank East Chair	714
1385047336	1385049137	3231713	Mott House Steve Office	Steve's Check In WATCH Area	1801
1385047323	1385048132	3231712	338	Firbank East Chair	809
1385047317	1385049118	3231711	337	Firbank East Bed	1801
1385047306	1385049109	3231710	351	Firbank East Bath	1803
1385047266	1385049069	3231708	339	Firbank East Chair	1803
1385047248	1385049051	3231706	KEN GEN Switch OFF Boiler room Kendal OLD	STEVES HOLD UN-USED DEVICE AREA	1803
1385047164	1385048966	3231703	548 BED	STEVES HOLD UN-USED DEVICE AREA	1802
1385047123	1385048168	3231702	F09FE0 Resident shepherd, janet, Room 349 detected  at location: Main Dining Stair Tower/Library.	Kendal Roam Alert 	1045
1385047047	1385048850	3231700	336	Firbank East Bed	1803
1385046998	1385048801	3231699	343	Firbank East Chair	1803
1385046966	1385048768	3231697	BLAH	Steve's Check In WATCH Area	1802
1385046899	1385048702	3231696	355	Firbank East Bed	1803
1385046667	1385048096	3231693	350	Firbank East Bed	1429
1385046657	1385048459	3231692	335	Firbank East Bed	1802
1385046633	1385048434	3231691	352	Firbank East Bed	1801
1385046633	1385048434	3231690	353	Firbank East Bed	1801
1385046633	1385048434	3231689	356	Firbank East Chair	1801
1385046633	1385048434	3231688	348	Firbank East Chair	1801
1385046623	1385048425	3231687	345	Firbank East Chair	1802
1385046606	1385048409	3231686	344	Firbank East Chair	1803
1385046591	1385048135	3231683	334	Firbank East Chair	1544
1385046563	1385048365	3231681	HR Office Door	Office Activity	1802
1385046524	1385048325	3231680	349	Firbank East Chair	1801
1385046456	1385048257	3231679	338	Firbank East Bed	1801
1385046430	1385048232	3231678	333	Firbank East Bath	1802
1385046430	1385048134	3231677	340	Firbank East Bed	1704
1385046430	1385048232	3231676	337	Firbank East Chair	1802
1385046403	1385048204	3231674	333	Firbank East Bed	1801
1385046382	1385048183	3231672	341	Firbank East Bed	1801
1385046346	1385048147	3231669	341	Firbank East Chair	1801
1385046315	1385048118	3231664	349	Firbank East Bed	1803
1385046227	1385048028	3231660	333	Firbank East Chair	1801
1385046054	1385047857	3231658	331	Firbank East Bed	1803
1385046051	1385047854	3231657	336	Firbank East Chair	1803
1385046027	1385047830	3231656	334	Firbank East Bed	1803
1385045939	1385047742	3231653	355	Firbank East Bath	1803
1385045919	1385046402	3231650	Lydia Hall - Pendant	Audland Pendants	483
1385045849	1385047651	3231647	356	Firbank East Bed	1802
1385045824	1385047626	3231646	XL Firbank East RM  331	Repeaters and Locators	1802
1385045791	1385047592	3231645	Firbank East Door Pk Lot hol dstill there unused 11/12/12 steve	STEVES HOLD UN-USED DEVICE AREA	1801
1385045745	1385047546	3231644	335	Firbank East Chair	1801
1385045685	1385047487	3231639	353	Firbank East Chair	1802
1385045617	1385045879	3231637	402	Westmorland Dukane Bath	262
1385045595	1385047396	3231636	355	Firbank East Chair	1801
1385045580	1385047381	3231635	340	Firbank East Chair	1801
1385045546	1385046226	3231634	Kendal Apt 64	Steve's Check In WATCH Area	680
1385045546	1385047275	3231633	Kendal Apt  121	Steve's Check In WATCH Area	1729
1385045534	1385047336	3231631	Mott House Steve Office	Steve's Check In WATCH Area	1802
1385045520	1385047323	3231630	338	Firbank East Chair	1803
1385045515	1385047317	3231629	337	Firbank East Bed	1802
1385045503	1385047305	3231628	351	Firbank East Bath	1802
1385045463	1385047266	3231626	339	Firbank East Chair	1803
1385045445	1385047248	3231625	KEN GEN Switch OFF Boiler room Kendal OLD	STEVES HOLD UN-USED DEVICE AREA	1803
1385045361	1385047163	3231622	548 BED	STEVES HOLD UN-USED DEVICE AREA	1802
1385045258	1385045542	3231611	EXIT DOOR NEW WALKWAY TO PARKING	CROSSLANDS Door Alert Device	284
1385045243	1385047047	3231609	336	Firbank East Bed	1804
1385045197	1385046998	3231608	343	Firbank East Chair	1801
1385045164	1385046965	3231602	BLAH	Steve's Check In WATCH Area	1801
1385045098	1385046899	3231601	355	Firbank East Bed	1801
1385045091	1385045323	3231600	402	Westmorland Dukane Bed	232
1385044894	1385045971	3231595	Xlands Apt 241	Room Check Devices	1077
1385044864	1385046666	3231593	350	Firbank East Bed	1802
1385044854	1385046657	3231592	335	Firbank East Bed	1803
1385044831	1385046633	3231590	352	Firbank East Bed	1802
1385044831	1385046633	3231589	353	Firbank East Bed	1802
1385044829	1385046633	3231588	356	Firbank East Chair	1804
1385044829	1385046633	3231587	348	Firbank East Chair	1804
1385044821	1385046623	3231586	345	Firbank East Chair	1802
1385044802	1385046606	3231584	344	Firbank East Chair	1804
1385044790	1385046591	3231583	334	Firbank East Chair	1801
1385044760	1385046563	3231581	HR Office Door	Office Activity	1803
1385044721	1385046524	3231579	349	Firbank East Chair	1803
1385044655	1385046456	3231577	338	Firbank East Bed	1801
1385044628	1385046430	3231574	333	Firbank East Bath	1802
1385044628	1385046430	3231573	340	Firbank East Bed	1802
1385044628	1385046430	3231572	337	Firbank East Chair	1802
1385044601	1385046403	3231571	333	Firbank East Bed	1802
1385044580	1385046382	3231570	341	Firbank East Bed	1802
1385044514	1385046315	3231566	349	Firbank East Bed	1801
1385044499	1385046300	3231564	341	Firbank East Chair	1801
1385044425	1385046227	3231562	333	Firbank East Chair	1802
1385044253	1385046054	3231558	331	Firbank East Bed	1801
1385044250	1385046051	3231557	336	Firbank East Chair	1801
1385044224	1385046027	3231555	334	Firbank East Bed	1803
1385044138	1385045939	3231553	355	Firbank East Bath	1801
1385044047	1385045849	3231551	356	Firbank East Bed	1802
1385044023	1385045824	3231550	XL Firbank East RM  331	Repeaters and Locators	1801
1385043990	1385045791	3231549	Firbank East Door Pk Lot hol dstill there unused 11/12/12 steve	STEVES HOLD UN-USED DEVICE AREA	1801
1385043943	1385045745	3231547	335	Firbank East Chair	1802
1385043882	1385045685	3231546	353	Firbank East Chair	1803
1385043879	1385044308	3231545	EXIT DOOR NEW WALKWAY TO PARKING	CROSSLANDS Door Alert Device	429
1385043794	1385045595	3231542	355	Firbank East Chair	1801
1385043776	1385045580	3231540	340	Firbank East Chair	1804
1385043744	1385045546	3231539	Kendal Apt 64	Steve's Check In WATCH Area	1802
1385043744	1385045545	3231538	Kendal Apt  121	Steve's Check In WATCH Area	1801
1385043717	1385045520	3231537	338	Firbank East Chair	1803
1385043713	1385045515	3231536	337	Firbank East Bed	1802
1385043701	1385045503	3231535	351	Firbank East Bath	1802
1385043662	1385045463	3231533	339	Firbank East Chair	1801
1385043644	1385045445	3231532	KEN GEN Switch OFF Boiler room Kendal OLD	STEVES HOLD UN-USED DEVICE AREA	1801
1385043559	1385045361	3231530	548 BED	STEVES HOLD UN-USED DEVICE AREA	1802
1385043440	1385045243	3231527	336	Firbank East Bed	1803
1385043409	1385043727	3231526	Xlands Apt 241	Room Check Devices	318
1385043396	1385045197	3231525	343	Firbank East Chair	1801
1385043363	1385045164	3231524	BLAH	Steve's Check In WATCH Area	1801
1385043296	1385045098	3231521	355	Firbank East Bed	1802
1385043252	1385043782	3231519	619  BED Jesse Green	N Firbank West Bed	530
1385043250	1385043475	3231518	711 BATH Dorothy Schonhans	N Firbank Central Bath	225
1385043220	1385043462	3231517	XL LOT 8 PICK UP NEEDED	XL PARKING LOTS	242
1385043061	1385044864	3231516	350	Firbank East Bed	1803
1385043028	1385044831	3231514	352	Firbank East Bed	1803
1385043028	1385044831	3231513	353	Firbank East Bed	1803
1385043028	1385044829	3231512	356	Firbank East Chair	1801
1385043026	1385044829	3231511	348	Firbank East Chair	1803
1385043019	1385044820	3231510	345	Firbank East Chair	1801
1385043013	1385044814	3231508	335	Firbank East Bed	1801
1385043001	1385044802	3231507	344	Firbank East Chair	1801
1385042959	1385044760	3231506	HR Office Door	Office Activity	1801
1385042950	1385044751	3231505	334	Firbank East Chair	1801
1385042920	1385044721	3231504	349	Firbank East Chair	1801
1385042853	1385044655	3231500	338	Firbank East Bed	1802
1385042826	1385044628	3231499	333	Firbank East Bath	1802
1385042826	1385044628	3231498	340	Firbank East Bed	1802
1385042826	1385044628	3231497	337	Firbank East Chair	1802
1385042799	1385044601	3231496	333	Firbank East Bed	1802
1385042796	1385043164	3231495	403	Westmorland Dukane Bed	368
1385042778	1385044580	3231494	341	Firbank East Bed	1802
1385042744	1385043017	3231493	619  BED Jesse Green	N Firbank West Bed	273
1385042712	1385042974	3231490	406	Westmorland Dukane Bath	262
1385042711	1385044514	3231489	349	Firbank East Bed	1803
1385042711	1385043484	3231488	431	Westmorland Dukane Bed	773
1385042696	1385044498	3231487	341	Firbank East Chair	1802
1385042624	1385044425	3231485	333	Firbank East Chair	1801
1385042452	1385044253	3231480	331	Firbank East Bed	1801
1385042449	1385044250	3231478	336	Firbank East Chair	1801
1385042422	1385044224	3231477	334	Firbank East Bed	1802
1385042337	1385044138	3231472	355	Firbank East Bath	1801
1385042244	1385044047	3231466	356	Firbank East Bed	1803
1385042220	1385044023	3231464	XL Firbank East RM  331	Repeaters and Locators	1803
1385042188	1385043990	3231462	Firbank East Door Pk Lot hol dstill there unused 11/12/12 steve	STEVES HOLD UN-USED DEVICE AREA	1802
1385042139	1385043942	3231461	335	Firbank East Chair	1803
1385042079	1385043882	3231459	353	Firbank East Chair	1803
1385041991	1385043794	3231449	355	Firbank East Chair	1803
1385041973	1385043776	3231445	340	Firbank East Chair	1803
1385041940	1385043744	3231444	Kendal Apt 64	Steve's Check In WATCH Area	1804
1385041940	1385043744	3231443	Kendal Apt  121	Steve's Check In WATCH Area	1804
1385041915	1385043717	3231441	338	Firbank East Chair	1802
1385041912	1385043713	3231439	337	Firbank East Bed	1801
1385041900	1385043701	3231438	351	Firbank East Bath	1801
1385041861	1385043662	3231435	339	Firbank East Chair	1801
1385041842	1385043644	3231433	KEN GEN Switch OFF Boiler room Kendal OLD	STEVES HOLD UN-USED DEVICE AREA	1802
1385041757	1385043559	3231427	548 BED	STEVES HOLD UN-USED DEVICE AREA	1802
1385041638	1385043439	3231422	336	Firbank East Bed	1801
1385041595	1385043396	3231420	343	Firbank East Chair	1801
1385041562	1385043363	3231418	BLAH	Steve's Check In WATCH Area	1801
1385041493	1385043296	3231412	355	Firbank East Bed	1803
1385041368	1385041682	3231408	 618  BATH Elizabeth Green	N Firbank West Bath	314
1385041258	1385043061	3231397	350	Firbank East Bed	1803
1385041227	1385043028	3231396	352	Firbank East Bed	1801
1385041227	1385043028	3231395	353	Firbank East Bed	1801
1385041227	1385043028	3231394	356	Firbank East Chair	1801
1385041223	1385043026	3231393	348	Firbank East Chair	1803
1385041217	1385043019	3231392	345	Firbank East Chair	1802
1385041210	1385043013	3231390	335	Firbank East Bed	1803
1385041199	1385043001	3231388	344	Firbank East Chair	1802
1385041158	1385042959	3231384	HR Office Door	Office Activity	1801
1385041149	1385042950	3231381	334	Firbank East Chair	1801
1385041119	1385042920	3231379	349	Firbank East Chair	1801
1385041050	1385042853	3231377	338	Firbank East Bed	1803
1385041025	1385042826	3231374	333	Firbank East Bath	1801
1385041025	1385042826	3231373	340	Firbank East Bed	1801
1385041025	1385042826	3231372	337	Firbank East Chair	1801
1385041018	1385041270	3231371	308A Jeanne Wilson	Firbank Central Bed	252
1385040998	1385042799	3231369	333	Firbank East Bed	1801
1385040992	1385041306	3231365	FB 613 CHAIR Betty Limberger	N Firbank West Bed	314
1385040975	1385042778	3231363	341	Firbank East Bed	1803
1385040910	1385042711	3231356	349	Firbank East Bed	1801
1385040895	1385042696	3231355	341	Firbank East Chair	1801
1385040823	1385042624	3231351	333	Firbank East Chair	1801
1385040798	1385041143	3231346	304A Dorothy Dyck	Firbank West  Bed	345
1385040661	1385040989	3231344	317 Carol Crotty	Firbank Central Bed	328
1385040651	1385042452	3231343	331	Firbank East Bed	1801
1385040647	1385042449	3231342	336	Firbank East Chair	1802
1385040619	1385042422	3231340	334	Firbank East Bed	1803
1385040583	1385041249	3231338	408	Westmorland Dukane Bed	666
1385040534	1385042337	3231336	355	Firbank East Bath	1803
1385040441	1385042244	3231332	356	Firbank East Bed	1803
1385040417	1385042220	3231331	XL Firbank East RM  331	Repeaters and Locators	1803
1385040385	1385042188	3231328	Firbank East Door Pk Lot hol dstill there unused 11/12/12 steve	STEVES HOLD UN-USED DEVICE AREA	1803
1385040336	1385042139	3231326	335	Firbank East Chair	1803
1385040308	1385040941	3231324	FB 613 CHAIR Betty Limberger	N Firbank West Bed	633
1385040277	1385042079	3231323	353	Firbank East Chair	1802
1385040189	1385041991	3231320	355	Firbank East Chair	1802
1385040170	1385041973	3231318	340	Firbank East Chair	1803
1385040139	1385041940	3231315	Kendal Apt 64	Steve's Check In WATCH Area	1801
1385040112	1385041915	3231313	338	Firbank East Chair	1803
1385040109	1385041912	3231312	337	Firbank East Bed	1803
1385040097	1385041900	3231311	351	Firbank East Bath	1803
1385040059	1385041861	3231307	339	Firbank East Chair	1802
1385040041	1385041842	3231306	KEN GEN Switch OFF Boiler room Kendal OLD	STEVES HOLD UN-USED DEVICE AREA	1801
1385039955	1385041757	3231303	548 BED	STEVES HOLD UN-USED DEVICE AREA	1802
1385039835	1385041638	3231300	336	Firbank East Bed	1803
1385039794	1385041595	3231298	343	Firbank East Chair	1801
1385039772	1385041267	3231297	K-289	Steve's Check In WATCH Area	1495
1385039760	1385041562	3231295	BLAH	Steve's Check In WATCH Area	1802
1385039691	1385041493	3231294	355	Firbank East Bed	1802
1385039682	1385041226	3231293	EXIT DOOR AUDLAND BY 547	CROSSLANDS Door Alert Device	1544
1385039457	1385041258	3231283	350	Firbank East Bed	1801
1385039423	1385041227	3231276	352	Firbank East Bed	1804
1385039423	1385041227	3231275	353	Firbank East Bed	1804
1385039423	1385041227	3231274	356	Firbank East Chair	1804
1385039421	1385041223	3231273	348	Firbank East Chair	1802
1385039414	1385041217	3231272	345	Firbank East Chair	1803
1385039408	1385041210	3231270	335	Firbank East Bed	1802
1385039395	1385041198	3231266	344	Firbank East Chair	1803
1385039356	1385041158	3231265	HR Office Door	Office Activity	1802
1385039347	1385041149	3231264	334	Firbank East Chair	1802
1385039317	1385041119	3231263	349	Firbank East Chair	1802
1385039266	1385039565	3231262	718   BED Helen Scott	N Firbank Central Bed	299
1385039249	1385041050	3231261	338	Firbank East Bed	1801
1385039224	1385041025	3231260	333	Firbank East Bath	1801
1385039224	1385041025	3231259	340	Firbank East Bed	1801
1385039224	1385041025	3231258	337	Firbank East Chair	1801
1385039197	1385040998	3231254	333	Firbank East Bed	1801
1385039173	1385040975	3231251	341	Firbank East Bed	1802
1385039165	1385039401	3231250	FB 613 CHAIR Betty Limberger	N Firbank West Bed	236
1385039107	1385040910	3231247	349	Firbank East Bed	1803
1385039092	1385040895	3231246	341	Firbank East Chair	1803
1385039087	1385039336	3231245	445	Westmorland Dukane Bed	249
1385039021	1385040823	3231243	333	Firbank East Chair	1802
1385038914	1385039189	3231242	Lydia Hall - Pendant	Audland Pendants	275
1385038849	1385040650	3231240	331	Firbank East Bed	1801
1385038844	1385040647	3231239	336	Firbank East Chair	1803
1385038816	1385040619	3231237	334	Firbank East Bed	1803
1385038732	1385040534	3231235	355	Firbank East Bath	1802
1385038638	1385040441	3231232	356	Firbank East Bed	1803
1385038614	1385040417	3231231	XL Firbank East RM  331	Repeaters and Locators	1803
1385038583	1385040385	3231230	Firbank East Door Pk Lot hol dstill there unused 11/12/12 steve	STEVES HOLD UN-USED DEVICE AREA	1802
1385038537	1385038722	3231229	323 Ross Ballew	Firbank West  Bed	185
1385038536	1385040336	3231228	335	Firbank East Chair	1800
1385038474	1385040276	3231226	353	Firbank East Chair	1802
1385038390	1385039812	3231225	ES 577135 XL FALL  ES#3	XL W/C Fall Alarms	1422
1385038386	1385040189	3231224	355	Firbank East Chair	1803
1385038338	1385040139	3231221	Kendal Apt 64	Steve's Check In WATCH Area	1801
1385038329	1385040130	3231220	340	Firbank East Chair	1801
1385038309	1385040112	3231219	338	Firbank East Chair	1803
1385038309	1385040109	3231218	337	Firbank East Bed	1800
1385038293	1385040097	3231217	351	Firbank East Bath	1804
1385038257	1385040059	3231216	339	Firbank East Chair	1802
1385038239	1385040041	3231215	KEN GEN Switch OFF Boiler room Kendal OLD	STEVES HOLD UN-USED DEVICE AREA	1802
1385038154	1385039955	3231211	548 BED	STEVES HOLD UN-USED DEVICE AREA	1801
1385038033	1385039835	3231209	336	Firbank East Bed	1802
1385037992	1385039793	3231208	343	Firbank East Chair	1801
1385037970	1385039772	3231206	K-289	Steve's Check In WATCH Area	1802
1385037958	1385039760	3231205	BLAH	Steve's Check In WATCH Area	1802
1385037890	1385039691	3231201	355	Firbank East Bed	1801
1385037890	1385038533	3231200	 717  BED Don Scarborough	N Firbank Central Bed	643
1385037766	1385038006	3231199	441	Westmorland Dukane Bed	240
1385037692	1385039041	3231197	EXIT DOOR FIRBANK WEST NEAR RM 615	CROSSLANDS Door Alert Device	1349
1385037654	1385039457	3231195	350	Firbank East Bed	1803
1385037620	1385039423	3231193	352	Firbank East Bed	1803
1385037620	1385039423	3231192	353	Firbank East Bed	1803
1385037620	1385039423	3231191	356	Firbank East Chair	1803
1385037618	1385039420	3231189	348	Firbank East Chair	1802
1385037611	1385039414	3231188	345	Firbank East Chair	1803
1385037605	1385039408	3231187	335	Firbank East Bed	1803
1385037592	1385039395	3231186	344	Firbank East Chair	1803
1385037574	1385038802	3231185	Mott House Steve Office	Steve's Check In WATCH Area	1228
1385037554	1385039356	3231184	HR Office Door	Office Activity	1802
1385037546	1385039347	3231183	334	Firbank East Chair	1801
1385037516	1385039317	3231182	349	Firbank East Chair	1801
1385037446	1385039249	3231179	338	Firbank East Bed	1803
1385037422	1385039224	3231177	333	Firbank East Bath	1802
1385037422	1385039224	3231176	340	Firbank East Bed	1802
1385037394	1385039197	3231175	333	Firbank East Bed	1803
1385037376	1385039179	3231173	337	Firbank East Chair	1803
1385037372	1385039173	3231172	341	Firbank East Bed	1801
1385037305	1385039107	3231166	349	Firbank East Bed	1802
1385037290	1385039092	3231165	341	Firbank East Chair	1802
1385037220	1385039021	3231163	333	Firbank East Chair	1801
1385037047	1385038849	3231157	331	Firbank East Bed	1802
1385037041	1385038844	3231156	336	Firbank East Chair	1803
1385037015	1385038816	3231154	334	Firbank East Bed	1801
1385036930	1385038732	3231153	355	Firbank East Bath	1802
1385036836	1385038638	3231150	356	Firbank East Bed	1802
1385036818	1385037011	3231148	 717  BATH Don Scarborough	N Firbank Central Bath	193
1385036812	1385038614	3231147	XL Firbank East RM  331	Repeaters and Locators	1802
1385036782	1385038583	3231146	Firbank East Door Pk Lot hol dstill there unused 11/12/12 steve	STEVES HOLD UN-USED DEVICE AREA	1801
1385036734	1385038535	3231145	335	Firbank East Chair	1801
1385036672	1385038474	3231142	353	Firbank East Chair	1802
1385036589	1385038390	3231139	ES 577135 XL FALL  ES#3	XL W/C Fall Alarms	1801
1385036584	1385038386	3231138	355	Firbank East Chair	1802
1385036576	1385037053	3231136	346	Cumberland Dukane Bath	477
1385036536	1385038338	3231135	Kendal Apt 64	Steve's Check In WATCH Area	1802
1385036526	1385038329	3231134	340	Firbank East Chair	1803
1385036506	1385038308	3231133	338	Firbank East Chair	1802
1385036506	1385038308	3231131	337	Firbank East Bed	1802
1385036492	1385038293	3231121	351	Firbank East Bath	1801
1385036456	1385038257	3231119	339	Firbank East Chair	1801
1385036438	1385038239	3231116	KEN GEN Switch OFF Boiler room Kendal OLD	STEVES HOLD UN-USED DEVICE AREA	1801
1385036352	1385038154	3231111	548 BED	STEVES HOLD UN-USED DEVICE AREA	1802
1385036230	1385038033	3231109	336	Firbank East Bed	1803
1385036189	1385037991	3231108	343	Firbank East Chair	1802
1385036167	1385037970	3231106	K-289	Steve's Check In WATCH Area	1803
1385036155	1385037958	3231105	BLAH	Steve's Check In WATCH Area	1803
1385036088	1385037890	3231099	355	Firbank East Bed	1802
1385035958	1385036629	3231096	619  BED Jesse Green	N Firbank West Bed	671
1385035853	1385037654	3231093	350	Firbank East Bed	1801
1385035819	1385037620	3231091	352	Firbank East Bed	1801
1385035819	1385037620	3231090	353	Firbank East Bed	1801
1385035819	1385037620	3231089	356	Firbank East Chair	1801
1385035816	1385037618	3231088	348	Firbank East Chair	1802
1385035810	1385037611	3231087	345	Firbank East Chair	1801
1385035801	1385037605	3231084	335	Firbank East Bed	1804
1385035789	1385037592	3231082	344	Firbank East Chair	1803
1385035772	1385037574	3231081	Mott House Steve Office	Steve's Check In WATCH Area	1802
1385035744	1385037546	3231080	334	Firbank East Chair	1802
1385035714	1385037516	3231078	349	Firbank East Chair	1802
1385035645	1385037446	3231076	338	Firbank East Bed	1801
1385035621	1385037422	3231073	333	Firbank East Bath	1801
1385035621	1385037422	3231072	340	Firbank East Bed	1801
1385035591	1385037394	3231071	333	Firbank East Bed	1803
1385035573	1385037376	3231070	337	Firbank East Chair	1803
1385035527	1385037328	3231066	341	Firbank East Bed	1801
1385035502	1385037305	3231064	349	Firbank East Bed	1803
1385035486	1385037289	3231063	341	Firbank East Chair	1803
1385035417	1385037220	3231060	333	Firbank East Chair	1803
1385035368	1385035615	3231057	435	Westmorland Dukane Bed	247
1385035245	1385037047	3231051	331	Firbank East Bed	1802
1385035239	1385037041	3231050	336	Firbank East Chair	1802
1385035212	1385037015	3231049	334	Firbank East Bed	1803
1385035196	1385036124	3231048	307 Gus Schroeder	Firbank Central Bed	928
1385035165	1385035692	3231047	423	Westmorland Dukane Bed	527
1385035129	1385036930	3231045	355	Firbank East Bath	1801
1385035034	1385036836	3231043	356	Firbank East Bed	1802
1385035010	1385036812	3231040	XL Firbank East RM  331	Repeaters and Locators	1802
1385034980	1385036782	3231039	Firbank East Door Pk Lot hol dstill there unused 11/12/12 steve	STEVES HOLD UN-USED DEVICE AREA	1802
1385034977	1385035169	3231038	406	Westmorland Dukane Bath	192
1385034932	1385036734	3231035	335	Firbank East Chair	1802
1385034925	1385035813	3231034	 619  BATH Jesse Green	N Firbank West Bath	888
1385034869	1385036672	3231029	353	Firbank East Chair	1803
1385034781	1385036584	3231026	355	Firbank East Chair	1803
1385034733	1385036536	3231022	Kendal Apt 64	Steve's Check In WATCH Area	1803
1385034723	1385036526	3231021	340	Firbank East Chair	1803
1385034690	1385036492	3231020	351	Firbank East Bath	1802
1385034658	1385036459	3231018	338	Firbank East Chair	1801
1385034654	1385036456	3231017	339	Firbank East Chair	1802
1385034651	1385036453	3231016	337	Firbank East Bed	1802
1385034637	1385036438	3231014	KEN GEN Switch OFF Boiler room Kendal OLD	STEVES HOLD UN-USED DEVICE AREA	1801
1385034550	1385036352	3231007	548 BED	STEVES HOLD UN-USED DEVICE AREA	1802
1385034429	1385036230	3231004	336	Firbank East Bed	1801
1385034387	1385036188	3231001	343	Firbank East Chair	1801
1385034366	1385036167	3230998	K-289	Steve's Check In WATCH Area	1801
1385034353	1385036155	3230995	BLAH	Steve's Check In WATCH Area	1802
1385034296	1385034689	3230994	711 BED Dorothy Schonhans	N Firbank Central Bed	393
1385034286	1385036088	3230993	355	Firbank East Bed	1802
1385034049	1385035853	3230986	350	Firbank East Bed	1804
1385034017	1385035819	3230985	352	Firbank East Bed	1802
1385034017	1385035819	3230984	353	Firbank East Bed	1802
1385034017	1385035819	3230983	356	Firbank East Chair	1802
1385034013	1385035816	3230982	348	Firbank East Chair	1803
1385034008	1385035810	3230981	345	Firbank East Chair	1802
1385033998	1385035801	3230979	335	Firbank East Bed	1803
1385033988	1385035789	3230978	344	Firbank East Chair	1801
1385033968	1385035772	3230976	Mott House Steve Office	Steve's Check In WATCH Area	1804
1385033941	1385035744	3230974	334	Firbank East Chair	1803
1385033913	1385035714	3230973	349	Firbank East Chair	1801
1385033843	1385035645	3230971	338	Firbank East Bed	1802
1385033839	1385034922	3230970	EXIT DOOR NEW WALKWAY TO GARDEN	CROSSLANDS Door Alert Device	1083
1385033819	1385035621	3230968	333	Firbank East Bath	1802
1385033818	1385035621	3230967	340	Firbank East Bed	1803
1385033788	1385035591	3230964	333	Firbank East Bed	1803
1385033770	1385035573	3230962	337	Firbank East Chair	1803
1385033723	1385035527	3230961	341	Firbank East Bed	1804
1385033701	1385035502	3230959	349	Firbank East Bed	1801
1385033683	1385035486	3230958	341	Firbank East Chair	1803
1385033614	1385035417	3230956	333	Firbank East Chair	1803
1385033468	1385034144	3230952	619  BED Jesse Green	N Firbank West Bed	676
1385033463	1385035238	3230951	422	Westmorland Dukane Bed	1775
1385033442	1385035245	3230950	331	Firbank East Bed	1803
1385033437	1385035239	3230949	336	Firbank East Chair	1802
1385033409	1385035212	3230947	334	Firbank East Bed	1803
1385033327	1385035129	3230942	355	Firbank East Bath	1802
1385033278	1385033528	3230940	408	Westmorland Dukane Bed	250
1385033233	1385035034	3230937	356	Firbank East Bed	1801
1385033209	1385035010	3230934	XL Firbank East RM  331	Repeaters and Locators	1801
1385033190	1385033410	3230933	 619  BATH Jesse Green	N Firbank West Bath	220
1385033177	1385034980	3230932	Firbank East Door Pk Lot hol dstill there unused 11/12/12 steve	STEVES HOLD UN-USED DEVICE AREA	1803
1385033130	1385034932	3230931	335	Firbank East Chair	1802
1385033095	1385033300	3230930	EXIT DOOR NEW WALKWAY TO PARKING	CROSSLANDS Door Alert Device	205
1385033067	1385034869	3230928	353	Firbank East Chair	1802
1385032980	1385034781	3230926	355	Firbank East Chair	1801
1385032931	1385034733	3230924	Kendal Apt 64	Steve's Check In WATCH Area	1802
1385032922	1385034723	3230923	340	Firbank East Chair	1801
1385032889	1385034690	3230922	351	Firbank East Bath	1801
1385032855	1385034657	3230921	338	Firbank East Chair	1802
1385032852	1385034654	3230920	339	Firbank East Chair	1802
1385032849	1385034651	3230919	337	Firbank East Bed	1802
1385032834	1385034637	3230917	KEN GEN Switch OFF Boiler room Kendal OLD	STEVES HOLD UN-USED DEVICE AREA	1803
1385032832	1385033515	3230916	611 BATH Sally Scattergood	N Firbank West Bath	683
1385032749	1385034550	3230914	548 BED	STEVES HOLD UN-USED DEVICE AREA	1801
1385032627	1385034429	3230911	336	Firbank East Bed	1802
1385032586	1385034387	3230910	343	Firbank East Chair	1801
1385032550	1385034353	3230908	BLAH	Steve's Check In WATCH Area	1803
1385032483	1385034286	3230906	355	Firbank East Bed	1803
1385032248	1385034049	3230900	350	Firbank East Bed	1801
1385032214	1385034016	3230899	352	Firbank East Bed	1802
1385032214	1385034016	3230898	353	Firbank East Bed	1802
1385032214	1385034016	3230897	356	Firbank East Chair	1802
1385032211	1385034013	3230895	348	Firbank East Chair	1802
1385032205	1385034007	3230894	345	Firbank East Chair	1802
1385032197	1385033998	3230893	335	Firbank East Bed	1801
1385032187	1385033988	3230892	344	Firbank East Chair	1801
1385032137	1385033940	3230890	334	Firbank East Chair	1803
1385032110	1385033913	3230889	349	Firbank East Chair	1803
1385032042	1385033843	3230888	338	Firbank East Bed	1801
1385032037	1385033839	3230887	EXIT DOOR NEW WALKWAY TO GARDEN	CROSSLANDS Door Alert Device	1802
1385032016	1385033818	3230886	333	Firbank East Bath	1802
1385032016	1385033818	3230885	340	Firbank East Bed	1802
1385031985	1385033788	3230884	333	Firbank East Bed	1803
1385031967	1385033770	3230883	337	Firbank East Chair	1803
1385031921	1385033723	3230881	341	Firbank East Bed	1802
1385031900	1385033701	3230878	349	Firbank East Bed	1801
1385031880	1385033683	3230877	341	Firbank East Chair	1803
1385031813	1385033614	3230870	333	Firbank East Chair	1801
1385031639	1385033442	3230867	331	Firbank East Bed	1803
1385031633	1385033437	3230866	336	Firbank East Chair	1804
1385031607	1385033409	3230865	334	Firbank East Bed	1802
1385031526	1385033327	3230863	355	Firbank East Bath	1801
1385031498	1385032005	3230862	409	Westmorland Dukane Bed	507
1385031431	1385033233	3230861	356	Firbank East Bed	1802
1385031408	1385033209	3230859	XL Firbank East RM  331	Repeaters and Locators	1801
1385031374	1385033177	3230857	Firbank East Door Pk Lot hol dstill there unused 11/12/12 steve	STEVES HOLD UN-USED DEVICE AREA	1803
1385031346	1385031879	3230856	315	Cumberland Dukane Bed	533
1385031327	1385033130	3230855	335	Firbank East Chair	1803
1385031294	1385033095	3230854	EXIT DOOR NEW WALKWAY TO PARKING	CROSSLANDS Door Alert Device	1801
1385031266	1385033067	3230853	353	Firbank East Chair	1801
1385031178	1385032980	3230847	355	Firbank East Chair	1802
1385031128	1385032931	3230845	Kendal Apt 64	Steve's Check In WATCH Area	1803
1385031119	1385032922	3230844	340	Firbank East Chair	1803
1385031086	1385032889	3230842	351	Firbank East Bath	1803
1385031053	1385032855	3230841	338	Firbank East Chair	1802
1385031050	1385032852	3230840	339	Firbank East Chair	1802
1385031045	1385032849	3230839	337	Firbank East Bed	1804
1385031032	1385032834	3230838	KEN GEN Switch OFF Boiler room Kendal OLD	STEVES HOLD UN-USED DEVICE AREA	1802
1385030948	1385032749	3230837	548 BED	STEVES HOLD UN-USED DEVICE AREA	1801
1385030825	1385032627	3230835	336	Firbank East Bed	1802
1385030782	1385032586	3230834	343	Firbank East Chair	1804
1385030746	1385032549	3230833	BLAH	Steve's Check In WATCH Area	1803
1385030682	1385032483	3230831	355	Firbank East Bed	1801
1385030446	1385032248	3230828	350	Firbank East Bed	1802
1385030413	1385032214	3230827	352	Firbank East Bed	1801
1385030413	1385032214	3230826	353	Firbank East Bed	1801
1385030413	1385032214	3230825	356	Firbank East Chair	1801
1385030410	1385032211	3230824	348	Firbank East Chair	1801
1385030403	1385032205	3230823	345	Firbank East Chair	1802
1385030394	1385032197	3230822	335	Firbank East Bed	1803
1385030385	1385032187	3230820	344	Firbank East Chair	1802
1385030335	1385032137	3230815	334	Firbank East Chair	1802
1385030307	1385032110	3230813	349	Firbank East Chair	1803
1385030240	1385032041	3230811	338	Firbank East Bed	1801
1385030215	1385032016	3230810	333	Firbank East Bath	1801
1385030215	1385032016	3230809	340	Firbank East Bed	1801
1385030182	1385031985	3230807	333	Firbank East Bed	1803
1385030164	1385031967	3230805	337	Firbank East Chair	1803
1385030120	1385031921	3230803	341	Firbank East Bed	1801
1385030098	1385031900	3230801	349	Firbank East Bed	1802
1385030027	1385031829	3230800	341	Firbank East Chair	1802
1385030011	1385031813	3230799	333	Firbank East Chair	1802
1385029838	1385031639	3230798	331	Firbank East Bed	1801
1385029833	1385031633	3230797	336	Firbank East Chair	1800
1385029804	1385031606	3230796	334	Firbank East Bed	1802
1385029723	1385031526	3230795	355	Firbank East Bath	1803
1385029627	1385031431	3230794	356	Firbank East Bed	1804
1385029606	1385031408	3230793	XL Firbank East RM  331	Repeaters and Locators	1802
1385029571	1385031374	3230792	Firbank East Door Pk Lot hol dstill there unused 11/12/12 steve	STEVES HOLD UN-USED DEVICE AREA	1803
1385029524	1385031326	3230789	335	Firbank East Chair	1802
1385029465	1385031266	3230788	353	Firbank East Chair	1801
1385029375	1385031178	3230786	355	Firbank East Chair	1803
1385029325	1385031128	3230785	Kendal Apt 64	Steve's Check In WATCH Area	1803
1385029316	1385031119	3230784	340	Firbank East Chair	1803
1385029283	1385031086	3230783	351	Firbank East Bath	1803
1385029250	1385031053	3230782	338	Firbank East Chair	1803
1385029247	1385031050	3230781	339	Firbank East Chair	1803
1385029241	1385031045	3230780	337	Firbank East Bed	1804
1385029229	1385031032	3230778	KEN GEN Switch OFF Boiler room Kendal OLD	STEVES HOLD UN-USED DEVICE AREA	1803
1385029145	1385030948	3230775	548 BED	STEVES HOLD UN-USED DEVICE AREA	1803
1385029022	1385030824	3230774	336	Firbank East Bed	1802
1385028980	1385030782	3230773	343	Firbank East Chair	1802
1385028944	1385030746	3230771	BLAH	Steve's Check In WATCH Area	1802
1385028880	1385030682	3230770	355	Firbank East Bed	1802
1385028643	1385030446	3230769	350	Firbank East Bed	1803
1385028612	1385030413	3230768	352	Firbank East Bed	1801
1385028612	1385030413	3230767	353	Firbank East Bed	1801
1385028612	1385030413	3230766	356	Firbank East Chair	1801
1385028606	1385030410	3230765	348	Firbank East Chair	1804
1385028600	1385030403	3230764	345	Firbank East Chair	1803
1385028582	1385030385	3230763	344	Firbank East Chair	1803
1385028537	1385030340	3230762	335	Firbank East Bed	1803
1385028533	1385029564	3230761	405	Westmorland Dukane Bed	1031
1385028504	1385030307	3230760	349	Firbank East Chair	1803
1385028494	1385030295	3230759	334	Firbank East Chair	1801
1385028437	1385030240	3230757	338	Firbank East Bed	1803
1385028413	1385030215	3230756	333	Firbank East Bath	1802
1385028412	1385030215	3230755	340	Firbank East Bed	1803
1385028380	1385030182	3230754	333	Firbank East Bed	1802
1385028361	1385030164	3230753	337	Firbank East Chair	1803
1385028316	1385030120	3230752	341	Firbank East Bed	1804
1385028296	1385030098	3230751	349	Firbank East Bed	1802
1385028226	1385030027	3230749	341	Firbank East Chair	1801
1385028210	1385030011	3230748	333	Firbank East Chair	1801
1385028036	1385029838	3230742	331	Firbank East Bed	1802
1385028030	1385029832	3230741	336	Firbank East Chair	1802
1385028003	1385029804	3230740	334	Firbank East Bed	1801
1385027922	1385029723	3230739	355	Firbank East Bath	1801
1385027825	1385029627	3230738	356	Firbank East Bed	1802
1385027803	1385029606	3230737	XL Firbank East RM  331	Repeaters and Locators	1803
1385027767	1385029571	3230736	Firbank East Door Pk Lot hol dstill there unused 11/12/12 steve	STEVES HOLD UN-USED DEVICE AREA	1804
1385027722	1385029524	3230734	335	Firbank East Chair	1802
1385027661	1385029465	3230731	353	Firbank East Chair	1804
1385027573	1385029375	3230729	355	Firbank East Chair	1802
1385027522	1385029325	3230728	Kendal Apt 64	Steve's Check In WATCH Area	1803
1385027515	1385029316	3230727	340	Firbank East Chair	1801
1385027481	1385029283	3230726	351	Firbank East Bath	1802
1385027447	1385029250	3230725	338	Firbank East Chair	1803
1385027444	1385029247	3230724	339	Firbank East Chair	1803
1385027438	1385029241	3230723	337	Firbank East Bed	1803
1385027426	1385029229	3230722	KEN GEN Switch OFF Boiler room Kendal OLD	STEVES HOLD UN-USED DEVICE AREA	1803
1385027342	1385029145	3230721	548 BED	STEVES HOLD UN-USED DEVICE AREA	1803
1385027221	1385029022	3230719	336	Firbank East Bed	1801
1385027177	1385028980	3230715	343	Firbank East Chair	1803
1385027143	1385028944	3230714	BLAH	Steve's Check In WATCH Area	1801
1385027077	1385028880	3230713	355	Firbank East Bed	1803
1385026907	1385027089	3230711	445	Westmorland Dukane Bed	182
1385026842	1385028643	3230710	350	Firbank East Bed	1801
1385026809	1385028612	3230708	352	Firbank East Bed	1803
1385026809	1385028612	3230707	353	Firbank East Bed	1803
1385026809	1385028612	3230706	356	Firbank East Chair	1803
1385026803	1385028606	3230705	348	Firbank East Chair	1803
1385026797	1385028600	3230704	345	Firbank East Chair	1803
1385026779	1385028582	3230702	344	Firbank East Chair	1803
1385026733	1385028537	3230701	335	Firbank East Bed	1804
1385026700	1385028503	3230700	349	Firbank East Chair	1803
1385026691	1385028494	3230699	334	Firbank East Chair	1803
1385026636	1385028437	3230698	338	Firbank East Bed	1801
1385026610	1385028412	3230697	333	Firbank East Bath	1802
1385026610	1385028412	3230696	340	Firbank East Bed	1802
1385026577	1385028380	3230694	333	Firbank East Bed	1803
1385026559	1385028361	3230693	337	Firbank East Chair	1802
1385026513	1385028316	3230691	341	Firbank East Bed	1803
1385026492	1385028296	3230690	349	Firbank East Bed	1804
1385026423	1385028226	3230689	341	Firbank East Chair	1803
1385026407	1385028210	3230687	333	Firbank East Chair	1803
1385026284	1385026761	3230684	EXIT DOOR NEW WALKWAY TO PARKING	CROSSLANDS Door Alert Device	477
1385026235	1385028036	3230683	331	Firbank East Bed	1801
1385026229	1385028030	3230682	336	Firbank East Chair	1801
1385026202	1385028003	3230681	334	Firbank East Bed	1801
1385026121	1385027922	3230680	355	Firbank East Bath	1801
1385026024	1385027825	3230679	356	Firbank East Bed	1801
1385026000	1385027803	3230678	XL Firbank East RM  331	Repeaters and Locators	1803
1385025966	1385027767	3230677	Firbank East Door Pk Lot hol dstill there unused 11/12/12 steve	STEVES HOLD UN-USED DEVICE AREA	1801
1385025921	1385027722	3230676	335	Firbank East Chair	1801
1385025858	1385027661	3230675	353	Firbank East Chair	1803
1385025770	1385027573	3230674	355	Firbank East Chair	1803
1385025721	1385027522	3230673	Kendal Apt 64	Steve's Check In WATCH Area	1801
1385025712	1385027515	3230672	340	Firbank East Chair	1803
1385025680	1385025877	3230668	405	Westmorland Dukane Bed	197
1385025679	1385027481	3230667	351	Firbank East Bath	1802
1385025646	1385027447	3230665	338	Firbank East Chair	1801
1385025643	1385027444	3230664	339	Firbank East Chair	1801
1385025637	1385027438	3230663	337	Firbank East Bed	1801
1385025623	1385027426	3230662	KEN GEN Switch OFF Boiler room Kendal OLD	STEVES HOLD UN-USED DEVICE AREA	1803
1385025540	1385027342	3230661	548 BED	STEVES HOLD UN-USED DEVICE AREA	1802
1385025418	1385027221	3230660	336	Firbank East Bed	1803
1385025373	1385027176	3230659	343	Firbank East Chair	1803
1385025340	1385027143	3230658	BLAH	Steve's Check In WATCH Area	1803
1385025276	1385027077	3230657	355	Firbank East Bed	1801
1385025185	1385025755	3230656	401	Westmorland Dukane Bath	570
1385025184	1385025755	3230655	401	Westmorland Dukane Bed	571
1385025041	1385026842	3230651	350	Firbank East Bed	1801
1385025008	1385026809	3230650	352	Firbank East Bed	1801
1385025008	1385026809	3230649	353	Firbank East Bed	1801
1385025008	1385026809	3230648	356	Firbank East Chair	1801
1385025001	1385026803	3230647	348	Firbank East Chair	1802
1385024995	1385026797	3230646	345	Firbank East Chair	1802
1385024986	1385025206	3230645	 619  BATH Jesse Green	N Firbank West Bath	220
1385024977	1385026779	3230644	344	Firbank East Chair	1802
1385024932	1385026733	3230643	335	Firbank East Bed	1801
1385024900	1385026700	3230642	349	Firbank East Chair	1800
1385024890	1385026691	3230641	334	Firbank East Chair	1801
1385024852	1385025262	3230640	422	Westmorland Dukane Bed	410
1385024833	1385026636	3230639	338	Firbank East Bed	1803
1385024808	1385026610	3230638	333	Firbank East Bath	1802
1385024808	1385026610	3230637	340	Firbank East Bed	1802
1385024776	1385026577	3230636	333	Firbank East Bed	1801
1385024758	1385026559	3230635	337	Firbank East Chair	1801
1385024711	1385026513	3230630	341	Firbank East Bed	1802
1385024689	1385026492	3230628	349	Firbank East Bed	1803
1385024624	1385024934	3230627	447	Westmorland Dukane Bed	310
1385024622	1385026423	3230626	341	Firbank East Chair	1801
1385024604	1385026407	3230625	333	Firbank East Chair	1803
1385024432	1385026235	3230622	331	Firbank East Bed	1803
1385024428	1385026229	3230621	336	Firbank East Chair	1801
1385024401	1385026202	3230619	334	Firbank East Bed	1801
1385024399	1385024579	3230618	416	Westmorland Dukane Bed	180
1385024317	1385026121	3230617	355	Firbank East Bath	1804
1385024223	1385026024	3230616	356	Firbank East Bed	1801
1385024199	1385026000	3230615	XL Firbank East RM  331	Repeaters and Locators	1801
1385024163	1385025966	3230613	Firbank East Door Pk Lot hol dstill there unused 11/12/12 steve	STEVES HOLD UN-USED DEVICE AREA	1803
1385024118	1385025921	3230612	335	Firbank East Chair	1803
1385024056	1385025858	3230611	353	Firbank East Chair	1802
1385024053	1385024377	3230610	EXIT DOOR NEW WALKWAY TO PARKING	CROSSLANDS Door Alert Device	324
1385023967	1385025770	3230608	355	Firbank East Chair	1803
1385023919	1385025721	3230607	Kendal Apt 64	Steve's Check In WATCH Area	1802
1385023877	1385025679	3230604	351	Firbank East Bath	1802
1385023858	1385025661	3230603	340	Firbank East Chair	1803
1385023843	1385025646	3230602	338	Firbank East Chair	1803
1385023840	1385025643	3230601	339	Firbank East Chair	1803
1385023834	1385025637	3230600	337	Firbank East Bed	1803
1385023821	1385025623	3230599	KEN GEN Switch OFF Boiler room Kendal OLD	STEVES HOLD UN-USED DEVICE AREA	1802
1385023736	1385025540	3230598	548 BED	STEVES HOLD UN-USED DEVICE AREA	1804
1385023616	1385025418	3230597	336	Firbank East Bed	1802
1385023570	1385025373	3230595	343	Firbank East Chair	1803
1385023537	1385025340	3230594	BLAH	Steve's Check In WATCH Area	1803
1385023474	1385025276	3230593	355	Firbank East Bed	1802
1385023239	1385025041	3230592	350	Firbank East Bed	1802
1385023205	1385025008	3230591	352	Firbank East Bed	1803
1385023205	1385025008	3230590	353	Firbank East Bed	1803
1385023205	1385025008	3230589	356	Firbank East Chair	1803
1385023200	1385025001	3230588	348	Firbank East Chair	1801
1385023193	1385024995	3230587	345	Firbank East Chair	1802
1385023187	1385024075	3230586	711 BATH Dorothy Schonhans	N Firbank Central Bath	888
1385023175	1385024977	3230585	344	Firbank East Chair	1802
1385023130	1385024932	3230584	335	Firbank East Bed	1802
1385023096	1385024899	3230583	349	Firbank East Chair	1803
1385023087	1385024890	3230582	334	Firbank East Chair	1803
1385023031	1385024833	3230580	338	Firbank East Bed	1802
1385023006	1385024808	3230579	333	Firbank East Bath	1802
1385023006	1385024808	3230578	340	Firbank East Bed	1802
1385022973	1385024776	3230577	333	Firbank East Bed	1803
1385022907	1385024711	3230576	341	Firbank East Bed	1804
1385022906	1385024707	3230574	337	Firbank East Chair	1801
1385022888	1385024689	3230573	349	Firbank East Bed	1801
1385022820	1385024622	3230570	341	Firbank East Chair	1802
1385022801	1385024604	3230569	333	Firbank East Chair	1803
1385022631	1385024432	3230567	331	Firbank East Bed	1801
1385022626	1385024428	3230566	336	Firbank East Chair	1802
1385022598	1385024401	3230565	334	Firbank East Bed	1803
1385022516	1385024317	3230564	355	Firbank East Bath	1801
1385022478	1385022670	3230562	401	Westmorland Dukane Bath	192
1385022477	1385022670	3230561	401	Westmorland Dukane Bed	193
1385022421	1385024223	3230560	356	Firbank East Bed	1802
1385022398	1385024199	3230559	XL Firbank East RM  331	Repeaters and Locators	1801
1385022361	1385024163	3230556	Firbank East Door Pk Lot hol dstill there unused 11/12/12 steve	STEVES HOLD UN-USED DEVICE AREA	1802
1385022316	1385024118	3230555	335	Firbank East Chair	1802
1385022255	1385024056	3230554	353	Firbank East Chair	1801
1385022164	1385023967	3230553	355	Firbank East Chair	1803
1385022116	1385023919	3230552	Kendal Apt 64	Steve's Check In WATCH Area	1803
1385022077	1385023879	3230551	 619  BATH Jesse Green	N Firbank West Bath	1802
1385022073	1385023877	3230550	351	Firbank East Bath	1804
1385022055	1385023858	3230549	340	Firbank East Chair	1803
1385022042	1385023843	3230547	338	Firbank East Chair	1801
1385022037	1385023840	3230545	339	Firbank East Chair	1803
1385022033	1385023834	3230544	337	Firbank East Bed	1801
1385022019	1385023821	3230539	KEN GEN Switch OFF Boiler room Kendal OLD	STEVES HOLD UN-USED DEVICE AREA	1802
1385021934	1385023736	3230534	548 BED	STEVES HOLD UN-USED DEVICE AREA	1802
1385021813	1385023616	3230533	336	Firbank East Bed	1803
1385021801	1385021991	3230532	711 BED Dorothy Schonhans	N Firbank Central Bed	190
1385021767	1385023570	3230531	343	Firbank East Chair	1803
1385021734	1385023537	3230530	BLAH	Steve's Check In WATCH Area	1803
1385021673	1385023474	3230528	355	Firbank East Bed	1801
1385021436	1385023239	3230525	350	Firbank East Bed	1803
1385021402	1385023205	3230524	352	Firbank East Bed	1803
1385021402	1385023205	3230523	353	Firbank East Bed	1803
1385021402	1385023205	3230522	356	Firbank East Chair	1803
1385021396	1385023199	3230521	348	Firbank East Chair	1803
1385021390	1385023193	3230520	345	Firbank East Chair	1803
1385021372	1385023175	3230519	344	Firbank East Chair	1803
1385021329	1385023130	3230518	335	Firbank East Bed	1801
1385021293	1385023096	3230517	349	Firbank East Chair	1803
1385021284	1385023087	3230516	334	Firbank East Chair	1803
1385021229	1385023030	3230515	338	Firbank East Bed	1801
1385021205	1385023006	3230514	333	Firbank East Bath	1801
1385021205	1385023006	3230513	340	Firbank East Bed	1801
1385021169	1385022973	3230510	333	Firbank East Bed	1804
1385021103	1385022906	3230508	337	Firbank East Chair	1803
1385021085	1385022888	3230507	349	Firbank East Bed	1803
1385021060	1385022861	3230506	341	Firbank East Bed	1801
1385021018	1385022819	3230505	341	Firbank East Chair	1801
1385020999	1385022801	3230504	333	Firbank East Chair	1802
1385020985	1385021374	3230503	EXIT DOOR NEW WALKWAY TO PARKING	CROSSLANDS Door Alert Device	389
1385020830	1385022631	3230501	331	Firbank East Bed	1801
1385020824	1385022626	3230500	336	Firbank East Chair	1802
1385020797	1385022598	3230499	334	Firbank East Bed	1801
1385020713	1385022516	3230498	355	Firbank East Bath	1803
1385020619	1385022421	3230497	356	Firbank East Bed	1802
1385020594	1385022398	3230496	XL Firbank East RM  331	Repeaters and Locators	1804
1385020558	1385022361	3230495	Firbank East Door Pk Lot hol dstill there unused 11/12/12 steve	STEVES HOLD UN-USED DEVICE AREA	1803
1385020513	1385022316	3230494	335	Firbank East Chair	1803
1385020452	1385022255	3230493	353	Firbank East Chair	1803
1385020362	1385022164	3230492	355	Firbank East Chair	1802
1385020314	1385022116	3230491	Kendal Apt 64	Steve's Check In WATCH Area	1802
1385020271	1385022073	3230490	351	Firbank East Bath	1802
1385020253	1385022055	3230489	340	Firbank East Chair	1802
1385020235	1385022037	3230488	339	Firbank East Chair	1802
1385020217	1385022019	3230487	KEN GEN Switch OFF Boiler room Kendal OLD	STEVES HOLD UN-USED DEVICE AREA	1802
1385020205	1385022007	3230486	338	Firbank East Chair	1802
1385020175	1385021977	3230484	337	Firbank East Bed	1802
1385020133	1385021934	3230482	548 BED	STEVES HOLD UN-USED DEVICE AREA	1801
1385020012	1385021813	3230481	336	Firbank East Bed	1801
1385019965	1385021767	3230480	343	Firbank East Chair	1802
1385019931	1385021734	3230479	BLAH	Steve's Check In WATCH Area	1803
1385019871	1385021673	3230478	355	Firbank East Bed	1802
1385019635	1385021436	3230473	350	Firbank East Bed	1801
1385019602	1385021402	3230472	352	Firbank East Bed	1800
1385019601	1385021402	3230471	353	Firbank East Bed	1801
1385019601	1385021402	3230470	356	Firbank East Chair	1801
1385019595	1385021396	3230469	348	Firbank East Chair	1801
1385019589	1385021390	3230468	345	Firbank East Chair	1801
1385019571	1385021372	3230467	344	Firbank East Chair	1801
1385019526	1385021329	3230466	335	Firbank East Bed	1803
1385019490	1385021293	3230465	349	Firbank East Chair	1803
1385019482	1385021284	3230464	334	Firbank East Chair	1802
1385019427	1385021229	3230461	338	Firbank East Bed	1802
1385019403	1385021205	3230460	333	Firbank East Bath	1802
1385019403	1385021205	3230459	340	Firbank East Bed	1802
1385019366	1385021169	3230458	333	Firbank East Bed	1803
1385019302	1385021103	3230457	337	Firbank East Chair	1801
1385019285	1385019493	3230456	337	Cumberland Dukane Bed	208
1385019282	1385021085	3230455	349	Firbank East Bed	1803
1385019259	1385021060	3230454	341	Firbank East Bed	1801
1385019215	1385021018	3230453	341	Firbank East Chair	1803
1385019196	1385020999	3230452	333	Firbank East Chair	1803
1385019028	1385020830	3230450	331	Firbank East Bed	1802
1385019023	1385020824	3230449	336	Firbank East Chair	1801
1385018994	1385020797	3230447	334	Firbank East Bed	1803
1385018910	1385020713	3230445	355	Firbank East Bath	1803
1385018816	1385020619	3230444	356	Firbank East Bed	1803
1385018792	1385020594	3230443	XL Firbank East RM  331	Repeaters and Locators	1802
1385018755	1385020558	3230441	Firbank East Door Pk Lot hol dstill there unused 11/12/12 steve	STEVES HOLD UN-USED DEVICE AREA	1803
1385018710	1385020513	3230440	335	Firbank East Chair	1803
1385018650	1385020452	3230438	353	Firbank East Chair	1802
1385018561	1385020362	3230437	355	Firbank East Chair	1801
1385018512	1385020314	3230436	Kendal Apt 64	Steve's Check In WATCH Area	1802
1385018471	1385018709	3230435	611 BED Sally Scattergood	N Firbank West Bed	238
1385018469	1385020271	3230434	351	Firbank East Bath	1802
1385018451	1385020253	3230433	340	Firbank East Chair	1802
1385018434	1385020235	3230432	339	Firbank East Chair	1801
1385018415	1385020217	3230431	KEN GEN Switch OFF Boiler room Kendal OLD	STEVES HOLD UN-USED DEVICE AREA	1802
1385018404	1385020205	3230430	338	Firbank East Chair	1801
1385018372	1385020175	3230427	337	Firbank East Bed	1803
1385018332	1385020133	3230425	548 BED	STEVES HOLD UN-USED DEVICE AREA	1801
1385018211	1385020012	3230424	336	Firbank East Bed	1801
1385018163	1385019965	3230422	343	Firbank East Chair	1802
1385018129	1385019931	3230421	BLAH	Steve's Check In WATCH Area	1802
1385018069	1385019871	3230419	355	Firbank East Bed	1802
1385017832	1385019634	3230418	350	Firbank East Bed	1802
1385017799	1385019601	3230417	352	Firbank East Bed	1802
1385017799	1385019601	3230416	353	Firbank East Bed	1802
1385017799	1385019601	3230415	356	Firbank East Chair	1802
1385017793	1385019595	3230414	348	Firbank East Chair	1802
1385017787	1385019589	3230413	345	Firbank East Chair	1802
1385017769	1385019571	3230412	344	Firbank East Chair	1802
1385017723	1385019526	3230410	335	Firbank East Bed	1803
1385017688	1385019490	3230409	349	Firbank East Chair	1802
1385017678	1385019482	3230408	334	Firbank East Chair	1804
1385017624	1385019427	3230407	338	Firbank East Bed	1803
1385017600	1385019403	3230406	333	Firbank East Bath	1803
1385017600	1385019403	3230405	340	Firbank East Bed	1803
1385017563	1385019366	3230404	333	Firbank East Bed	1803
1385017498	1385019302	3230403	337	Firbank East Chair	1804
1385017480	1385019282	3230401	349	Firbank East Bed	1802
1385017456	1385019258	3230400	341	Firbank East Bed	1802
1385017414	1385019215	3230397	341	Firbank East Chair	1801
1385017393	1385019196	3230391	333	Firbank East Chair	1803
1385017227	1385019028	3230389	331	Firbank East Bed	1801
1385017191	1385018994	3230388	334	Firbank East Bed	1803
1385017167	1385018970	3230387	336	Firbank East Chair	1803
1385017107	1385018909	3230386	355	Firbank East Bath	1802
1385017015	1385018816	3230385	356	Firbank East Bed	1801
1385016990	1385018792	3230384	XL Firbank East RM  331	Repeaters and Locators	1802
1385016953	1385018755	3230382	Firbank East Door Pk Lot hol dstill there unused 11/12/12 steve	STEVES HOLD UN-USED DEVICE AREA	1802
1385016908	1385018710	3230380	335	Firbank East Chair	1802
1385016849	1385018650	3230379	353	Firbank East Chair	1801
1385016758	1385018561	3230373	355	Firbank East Chair	1803
1385016710	1385018512	3230370	Kendal Apt 64	Steve's Check In WATCH Area	1802
1385016668	1385018469	3230369	351	Firbank East Bath	1801
1385016650	1385018451	3230367	340	Firbank East Chair	1801
1385016630	1385018433	3230365	339	Firbank East Chair	1803
1385016614	1385018415	3230364	KEN GEN Switch OFF Boiler room Kendal OLD	STEVES HOLD UN-USED DEVICE AREA	1801
1385016600	1385018404	3230363	338	Firbank East Chair	1804
1385016569	1385018372	3230362	337	Firbank East Bed	1803
1385016530	1385018332	3230361	548 BED	STEVES HOLD UN-USED DEVICE AREA	1802
1385016408	1385018211	3230359	336	Firbank East Bed	1803
1385016361	1385018163	3230356	343	Firbank East Chair	1802
1385016328	1385018129	3230355	BLAH	Steve's Check In WATCH Area	1801
1385016268	1385018069	3230354	355	Firbank East Bed	1801
1385016031	1385017832	3230352	350	Firbank East Bed	1801
1385015998	1385017799	3230351	352	Firbank East Bed	1801
1385015998	1385017799	3230350	353	Firbank East Bed	1801
1385015998	1385017799	3230349	356	Firbank East Chair	1801
1385015992	1385017793	3230348	348	Firbank East Chair	1801
1385015987	1385017302	3230347	305 Bath	Firbank Central Bath	1315
1385015986	1385017787	3230346	345	Firbank East Chair	1801
1385015968	1385017769	3230345	344	Firbank East Chair	1801
1385015921	1385017723	3230343	335	Firbank East Bed	1802
1385015884	1385017688	3230341	349	Firbank East Chair	1804
1385015875	1385017678	3230339	334	Firbank East Chair	1803
1385015821	1385017624	3230336	338	Firbank East Bed	1803
1385015797	1385017600	3230335	333	Firbank East Bath	1803
1385015797	1385017600	3230334	340	Firbank East Bed	1803
1385015761	1385017563	3230332	333	Firbank East Bed	1802
1385015696	1385017498	3230329	337	Firbank East Chair	1802
1385015677	1385017480	3230328	349	Firbank East Bed	1803
1385015653	1385017456	3230327	341	Firbank East Bed	1803
1385015645	1385015944	3230325	 618  BED Elizabeth Green	N Firbank West Bed	299
1385015590	1385017393	3230321	333	Firbank East Chair	1803
1385015566	1385017369	3230320	341	Firbank East Chair	1803
1385015426	1385017227	3230319	331	Firbank East Bed	1801
1385015390	1385017191	3230318	334	Firbank East Bed	1801
1385015366	1385017167	3230316	336	Firbank East Chair	1801
1385015305	1385017107	3230315	355	Firbank East Bath	1802
1385015213	1385017014	3230313	356	Firbank East Bed	1801
1385015187	1385016990	3230312	XL Firbank East RM  331	Repeaters and Locators	1803
1385015151	1385016953	3230311	Firbank East Door Pk Lot hol dstill there unused 11/12/12 steve	STEVES HOLD UN-USED DEVICE AREA	1802
1385015106	1385016908	3230310	335	Firbank East Chair	1802
1385015047	1385016849	3230309	353	Firbank East Chair	1802
1385014956	1385016758	3230308	355	Firbank East Chair	1802
1385014909	1385016710	3230306	Kendal Apt 64	Steve's Check In WATCH Area	1801
1385014866	1385016668	3230305	351	Firbank East Bath	1802
1385014848	1385016650	3230304	340	Firbank East Chair	1802
1385014827	1385016629	3230303	339	Firbank East Chair	1802
1385014812	1385016614	3230302	KEN GEN Switch OFF Boiler room Kendal OLD	STEVES HOLD UN-USED DEVICE AREA	1802
1385014796	1385016599	3230301	338	Firbank East Chair	1803
1385014768	1385016569	3230300	337	Firbank East Bed	1801
1385014727	1385016530	3230299	548 BED	STEVES HOLD UN-USED DEVICE AREA	1803
1385014604	1385016407	3230298	336	Firbank East Bed	1803
1385014559	1385016361	3230297	343	Firbank East Chair	1802
1385014526	1385016328	3230296	BLAH	Steve's Check In WATCH Area	1802
1385014467	1385016268	3230295	355	Firbank East Bed	1801
1385014229	1385016031	3230294	350	Firbank East Bed	1802
1385014196	1385015998	3230293	352	Firbank East Bed	1802
1385014196	1385015998	3230292	353	Firbank East Bed	1802
1385014196	1385015998	3230291	356	Firbank East Chair	1802
1385014190	1385015992	3230290	348	Firbank East Chair	1802
1385014184	1385015986	3230289	345	Firbank East Chair	1802
1385014165	1385015968	3230288	344	Firbank East Chair	1803
1385014081	1385015884	3230287	349	Firbank East Chair	1803
1385014078	1385015881	3230286	335	Firbank East Bed	1803
1385014018	1385015821	3230285	334	Firbank East Chair	1803
1385014018	1385015821	3230284	338	Firbank East Bed	1803
1385013995	1385015797	3230283	333	Firbank East Bath	1802
1385013994	1385015797	3230282	340	Firbank East Bed	1803
1385013959	1385015761	3230281	333	Firbank East Bed	1802
1385013893	1385015695	3230280	337	Firbank East Chair	1802
1385013875	1385015677	3230279	349	Firbank East Bed	1802
1385013851	1385015653	3230278	341	Firbank East Bed	1802
1385013788	1385015590	3230277	333	Firbank East Chair	1802
1385013764	1385015566	3230276	341	Firbank East Chair	1802
1385013623	1385015426	3230275	331	Firbank East Bed	1803
1385013587	1385015390	3230274	334	Firbank East Bed	1803
1385013563	1385015366	3230273	336	Firbank East Chair	1803
1385013503	1385015305	3230272	355	Firbank East Bath	1802
1385013410	1385015212	3230269	356	Firbank East Bed	1802
1385013386	1385015187	3230268	XL Firbank East RM  331	Repeaters and Locators	1801
1385013348	1385015151	3230267	Firbank East Door Pk Lot hol dstill there unused 11/12/12 steve	STEVES HOLD UN-USED DEVICE AREA	1803
1385013303	1385015106	3230266	335	Firbank East Chair	1803
1385013282	1385013692	3230263	425	Westmorland Dukane Bed	410
1385013245	1385015047	3230262	353	Firbank East Chair	1802
1385013155	1385014956	3230261	355	Firbank East Chair	1801
1385013107	1385014908	3230259	Kendal Apt 64	Steve's Check In WATCH Area	1801
1385013064	1385014866	3230258	351	Firbank East Bath	1802
1385013046	1385014848	3230257	340	Firbank East Chair	1802
1385013025	1385014827	3230256	339	Firbank East Chair	1802
1385013011	1385014812	3230255	KEN GEN Switch OFF Boiler room Kendal OLD	STEVES HOLD UN-USED DEVICE AREA	1801
1385012993	1385014796	3230254	338	Firbank East Chair	1803
1385012969	1385013152	3230252	438	Westmorland Dukane Bed	183
1385012966	1385014768	3230251	337	Firbank East Bed	1802
1385012925	1385014726	3230250	548 BED	STEVES HOLD UN-USED DEVICE AREA	1801
1385012803	1385014604	3230248	336	Firbank East Bed	1801
1385012757	1385014559	3230247	343	Firbank East Chair	1802
1385012724	1385014526	3230246	BLAH	Steve's Check In WATCH Area	1802
1385012665	1385014466	3230244	355	Firbank East Bed	1801
1385012653	1385013182	3230243	Kendal Apt  106	Steve's Check In WATCH Area	529
1385012426	1385014229	3230242	350	Firbank East Bed	1803
1385012393	1385014196	3230240	353	Firbank East Bed	1803
1385012393	1385014196	3230239	356	Firbank East Chair	1803
1385012393	1385014196	3230238	352	Firbank East Bed	1803
1385012388	1385014190	3230237	348	Firbank East Chair	1802
1385012381	1385014184	3230236	345	Firbank East Chair	1803
1385012363	1385014165	3230235	344	Firbank East Chair	1802
1385012282	1385012491	3230233	EXIT DOOR FIRBANK WEST NEAR RM 615	CROSSLANDS Door Alert Device	209
1385012279	1385014081	3230232	349	Firbank East Chair	1802
1385012275	1385014078	3230231	335	Firbank East Bed	1803
1385012217	1385014018	3230228	334	Firbank East Chair	1801
1385012217	1385014018	3230227	338	Firbank East Bed	1801
1385012193	1385013994	3230226	340	Firbank East Bed	1801
1385012193	1385013995	3230225	333	Firbank East Bath	1802
1385012157	1385013959	3230224	333	Firbank East Bed	1802
1385012090	1385013893	3230223	337	Firbank East Chair	1803
1385012072	1385013875	3230222	349	Firbank East Bed	1803
1385012048	1385013851	3230221	341	Firbank East Bed	1803
1385012047	1385012324	3230220	 610   BED Thornton Vandersall	N Firbank West Bed	277
1385011985	1385013788	3230219	333	Firbank East Chair	1803
1385011962	1385013764	3230218	341	Firbank East Chair	1802
1385011822	1385013623	3230216	331	Firbank East Bed	1801
1385011786	1385013587	3230215	334	Firbank East Bed	1801
1385011762	1385013563	3230214	336	Firbank East Chair	1801
1385011702	1385013503	3230209	355	Firbank East Bath	1801
1385011628	1385013431	3230208	EXIT DOOR NEW WALKWAY TO PARKING	CROSSLANDS Door Alert Device	1803
1385011608	1385013410	3230207	356	Firbank East Bed	1802
1385011583	1385013386	3230206	XL Firbank East RM  331	Repeaters and Locators	1803
1385011545	1385013348	3230205	Firbank East Door Pk Lot hol dstill there unused 11/12/12 steve	STEVES HOLD UN-USED DEVICE AREA	1803
1385011502	1385013303	3230204	335	Firbank East Chair	1801
1385011442	1385013245	3230202	353	Firbank East Chair	1803
1385011382	1385012651	3230201	Kendal Apt  106	Steve's Check In WATCH Area	1269
1385011353	1385013155	3230200	355	Firbank East Chair	1802
1385011304	1385013107	3230199	Kendal Apt 64	Steve's Check In WATCH Area	1803
1385011263	1385013064	3230198	351	Firbank East Bath	1801
1385011244	1385013046	3230195	340	Firbank East Chair	1802
1385011223	1385013025	3230190	339	Firbank East Chair	1802
1385011210	1385013011	3230189	KEN GEN Switch OFF Boiler room Kendal OLD	STEVES HOLD UN-USED DEVICE AREA	1801
1385011191	1385012993	3230187	338	Firbank East Chair	1802
1385011165	1385012966	3230185	337	Firbank East Bed	1801
1385011123	1385012925	3230184	548 BED	STEVES HOLD UN-USED DEVICE AREA	1802
1385011002	1385012803	3230183	336	Firbank East Bed	1801
1385010954	1385012757	3230182	343	Firbank East Chair	1803
1385010923	1385012724	3230181	BLAH	Steve's Check In WATCH Area	1801
1385010862	1385012664	3230180	355	Firbank East Bed	1802
1385010624	1385012426	3230178	350	Firbank East Bed	1802
1385010592	1385012393	3230176	353	Firbank East Bed	1801
1385010592	1385012393	3230175	356	Firbank East Chair	1801
1385010592	1385012393	3230174	352	Firbank East Bed	1801
1385010585	1385012388	3230173	348	Firbank East Chair	1803
1385010579	1385012381	3230171	345	Firbank East Chair	1802
1385010561	1385012363	3230170	344	Firbank East Chair	1802
1385010480	1385012282	3230169	EXIT DOOR FIRBANK WEST NEAR RM 615	CROSSLANDS Door Alert Device	1802
1385010477	1385012279	3230168	349	Firbank East Chair	1802
1385010474	1385012275	3230167	335	Firbank East Bed	1801
1385010416	1385012217	3230165	334	Firbank East Chair	1801
1385010416	1385012217	3230164	338	Firbank East Bed	1801
1385010392	1385012193	3230163	340	Firbank East Bed	1801
1385010392	1385012193	3230162	333	Firbank East Bath	1801
1385010356	1385012157	3230160	333	Firbank East Bed	1801
1385010287	1385012090	3230159	337	Firbank East Chair	1803
1385010271	1385012072	3230157	349	Firbank East Bed	1801
1385010245	1385012048	3230156	341	Firbank East Bed	1803
1385010182	1385011985	3230154	333	Firbank East Chair	1803
1385010158	1385011961	3230153	341	Firbank East Chair	1803
1385010019	1385011822	3230152	331	Firbank East Bed	1803
